id,tweet_id,time,count,accu_count,exposed_user_count
212554733,535472323302682600,2014-11-20 11:38:45-05,27013,27013,60648501
212554734,535472323302682600,2014-11-20 12:08:45-05,4672,31685,10065346
212554735,535472323302682600,2014-11-20 12:38:45-05,2967,34652,7687504
212554736,535472323302682600,2014-11-20 13:08:45-05,2377,37029,5451430
212554737,535472323302682600,2014-11-20 13:38:45-05,1969,38998,4111796
212554738,535472323302682600,2014-11-20 14:08:45-05,1919,40917,4073359
212554739,535472323302682600,2014-11-20 14:38:45-05,1799,42716,4965808
212554740,535472323302682600,2014-11-20 15:08:45-05,1743,44459,4195805
212554741,535472323302682600,2014-11-20 15:38:45-05,1633,46092,3832463
212554742,535472323302682600,2014-11-20 16:08:45-05,1494,47586,3799951
212554743,535472323302682600,2014-11-20 16:38:45-05,1556,49142,4267437
212554744,535472323302682600,2014-11-20 17:08:45-05,1372,50514,3350704
212554745,535472323302682600,2014-11-20 17:38:45-05,1161,51675,2421240
212554746,535472323302682600,2014-11-20 18:08:45-05,1117,52792,2458482
212554747,535472323302682600,2014-11-20 18:38:45-05,956,53748,1988656
212554748,535472323302682600,2014-11-20 19:08:45-05,864,54612,1760195
212554749,535472323302682600,2014-11-20 19:38:45-05,760,55372,1519785
212554750,535472323302682600,2014-11-20 20:08:45-05,765,56137,1314390
212554751,535472323302682600,2014-11-20 20:38:45-05,1721,57858,4074344
212554752,535472323302682600,2014-11-20 21:08:45-05,730,58588,1694265
212554753,535472323302682600,2014-11-20 21:38:45-05,549,59137,1078324
212554754,535472323302682600,2014-11-20 22:08:45-05,419,59556,811743
212554755,535472323302682600,2014-11-20 22:38:45-05,375,59931,814878
212554756,535472323302682600,2014-11-20 23:08:45-05,298,60229,603917
212554757,535472323302682600,2014-11-20 23:38:45-05,291,60520,732114
212554758,535472323302682600,2014-11-21 00:08:45-05,539,61059,938028
212554759,535472323302682600,2014-11-21 00:38:45-05,509,61568,994170
212554760,535472323302682600,2014-11-21 01:08:45-05,303,61871,902997
212554761,535472323302682600,2014-11-21 01:38:45-05,258,62129,572734
212554762,535472323302682600,2014-11-21 02:08:45-05,175,62304,440253
212554763,535472323302682600,2014-11-21 02:38:45-05,152,62456,339519
212554764,535472323302682600,2014-11-21 03:08:45-05,169,62625,408488
212554765,535472323302682600,2014-11-21 03:38:45-05,165,62790,395979
212554766,535472323302682600,2014-11-21 04:08:45-05,153,62943,412455
212554767,535472323302682600,2014-11-21 04:38:45-05,182,63125,468249
212554768,535472323302682600,2014-11-21 05:08:45-05,200,63325,430854
212554769,535472323302682600,2014-11-21 05:38:45-05,186,63511,434681
212554770,535472323302682600,2014-11-21 06:08:45-05,186,63697,373598
212554771,535472323302682600,2014-11-21 06:38:45-05,254,63951,536809
212554772,535472323302682600,2014-11-21 07:08:45-05,256,64207,621881
212554773,535472323302682600,2014-11-21 07:38:45-05,281,64488,547215
212554774,535472323302682600,2014-11-21 08:08:45-05,285,64773,681752
212554775,535472323302682600,2014-11-21 08:38:45-05,310,65083,595266
212554776,535472323302682600,2014-11-21 09:08:45-05,291,65374,1022745
212554777,535472323302682600,2014-11-21 09:38:45-05,282,65656,1147583
212554778,535472323302682600,2014-11-21 10:08:45-05,297,65953,534106
212554779,535472323302682600,2014-11-21 10:38:45-05,254,66207,661557
212554780,535472323302682600,2014-11-21 11:08:45-05,242,66449,420146
212554781,535472323302682600,2014-11-21 11:38:45-05,233,66682,441532
212554782,535472323302682600,2014-11-21 12:08:45-05,244,66926,681411
212554783,535472323302682600,2014-11-21 12:38:45-05,290,67216,689862
212554784,535472323302682600,2014-11-21 13:08:45-05,282,67498,738819
212554785,535472323302682600,2014-11-21 13:38:45-05,269,67767,527215
212554786,535472323302682600,2014-11-21 14:08:45-05,220,67987,477611
212554787,535472323302682600,2014-11-21 14:38:45-05,206,68193,317522
212554788,535472323302682600,2014-11-21 15:08:45-05,208,68401,529714
212554789,535472323302682600,2014-11-21 15:38:45-05,218,68619,462019
212554790,535472323302682600,2014-11-21 16:08:45-05,213,68832,398143
212554791,535472323302682600,2014-11-21 16:38:45-05,245,69077,365982
212554792,535472323302682600,2014-11-21 17:08:45-05,222,69299,641749
212554793,535472323302682600,2014-11-21 17:38:45-05,219,69518,464074
212554794,535472323302682600,2014-11-21 18:08:45-05,313,69831,598513
212554795,535472323302682600,2014-11-21 18:38:45-05,351,70182,657886
212554796,535472323302682600,2014-11-21 19:08:45-05,226,70408,351497
212554797,535472323302682600,2014-11-21 19:38:45-05,173,70581,300760
212554798,535472323302682600,2014-11-21 20:08:45-05,168,70749,333956
212554799,535472323302682600,2014-11-21 20:38:45-05,168,70917,313629
212554800,535472323302682600,2014-11-21 21:08:45-05,184,71101,253448
212554801,535472323302682600,2014-11-21 21:38:45-05,164,71265,326927
212554802,535472323302682600,2014-11-21 22:08:45-05,133,71398,197658
212554803,535472323302682600,2014-11-21 22:38:45-05,127,71525,158789
212554804,535472323302682600,2014-11-21 23:08:45-05,102,71627,159820
212554805,535472323302682600,2014-11-21 23:38:45-05,95,71722,199716
212554806,535472323302682600,2014-11-22 00:08:45-05,86,71808,130290
212554807,535472323302682600,2014-11-22 00:38:45-05,82,71890,98125
212554808,535472323302682600,2014-11-22 01:08:45-05,72,71962,172667
212554809,535472323302682600,2014-11-22 01:38:45-05,82,72044,113972
212554810,535472323302682600,2014-11-22 02:08:45-05,74,72118,105421
212554811,535472323302682600,2014-11-22 02:38:45-05,99,72217,254549
212554812,535472323302682600,2014-11-22 03:08:45-05,96,72313,359137
212554813,535472323302682600,2014-11-22 03:38:45-05,113,72426,174710
212554814,535472323302682600,2014-11-22 04:08:45-05,104,72530,364826
212554815,535472323302682600,2014-11-22 04:38:45-05,94,72624,159322
212554816,535472323302682600,2014-11-22 05:08:45-05,103,72727,304567
212554817,535472323302682600,2014-11-22 05:38:45-05,116,72843,208287
212554818,535472323302682600,2014-11-22 06:08:45-05,128,72971,319097
212554819,535472323302682600,2014-11-22 06:38:45-05,125,73096,167037
212554820,535472323302682600,2014-11-22 07:08:45-05,129,73225,179421
212554821,535472323302682600,2014-11-22 07:38:45-05,163,73388,406902
212554822,535472323302682600,2014-11-22 08:08:45-05,131,73519,300483
212554823,535472323302682600,2014-11-22 08:38:45-05,161,73680,324181
212554824,535472323302682600,2014-11-22 09:08:45-05,164,73844,204495
212554825,535472323302682600,2014-11-22 09:38:45-05,155,73999,216607
212554826,535472323302682600,2014-11-22 10:08:45-05,167,74166,220364
212554827,535472323302682600,2014-11-22 10:38:45-05,189,74355,490354
212554828,535472323302682600,2014-11-22 11:08:45-05,784,75139,1747597
212554829,535472323302682600,2014-11-22 11:38:45-05,275,75414,446784
212554830,535472323302682600,2014-11-22 12:08:45-05,178,75592,322043
212554831,535472323302682600,2014-11-22 12:38:45-05,154,75746,296065
212554832,535472323302682600,2014-11-22 13:08:45-05,139,75885,258604
212554833,535472323302682600,2014-11-22 13:38:45-05,128,76013,222110
212554834,535472323302682600,2014-11-22 14:08:45-05,87,76100,110640
212554835,535472323302682600,2014-11-22 14:38:45-05,96,76196,163640
212554836,535472323302682600,2014-11-22 15:08:45-05,96,76292,129307
212554837,535472323302682600,2014-11-22 15:38:45-05,106,76398,164010
212554838,535472323302682600,2014-11-22 16:08:45-05,86,76484,154887
212554839,535472323302682600,2014-11-22 16:38:45-05,96,76580,142140
212554840,535472323302682600,2014-11-22 17:08:45-05,114,76694,150047
212554841,535472323302682600,2014-11-22 17:38:45-05,96,76790,159596
212554842,535472323302682600,2014-11-22 18:08:45-05,101,76891,123002
212554843,535472323302682600,2014-11-22 18:38:45-05,94,76985,149336
212554844,535472323302682600,2014-11-22 19:08:45-05,78,77063,180768
212554845,535472323302682600,2014-11-22 19:38:45-05,83,77146,134648
212554846,535472323302682600,2014-11-22 20:08:45-05,81,77227,175621
212554847,535472323302682600,2014-11-22 20:38:45-05,85,77312,99082
212554848,535472323302682600,2014-11-22 21:08:45-05,76,77388,118830
212554849,535472323302682600,2014-11-22 21:38:45-05,60,77448,94668
212554850,535472323302682600,2014-11-22 22:08:45-05,54,77502,76588
212554851,535472323302682600,2014-11-22 22:38:45-05,59,77561,108643
212554852,535472323302682600,2014-11-22 23:08:45-05,51,77612,84047
212554853,535472323302682600,2014-11-22 23:38:45-05,52,77664,119353
212554854,535472323302682600,2014-11-23 00:08:45-05,54,77718,164411
212554855,535472323302682600,2014-11-23 00:38:45-05,86,77804,137079
212554856,535472323302682600,2014-11-23 01:08:45-05,54,77858,89348
212554857,535472323302682600,2014-11-23 01:38:45-05,55,77913,91791
212554858,535472323302682600,2014-11-23 02:08:45-05,36,77949,45836
212554859,535472323302682600,2014-11-23 02:38:45-05,29,77978,88077
212554860,535472323302682600,2014-11-23 03:08:45-05,44,78022,48125
212554861,535472323302682600,2014-11-23 03:38:45-05,38,78060,26165
212554862,535472323302682600,2014-11-23 04:08:45-05,41,78101,73676
212554863,535472323302682600,2014-11-23 04:38:45-05,33,78134,130862
212554864,535472323302682600,2014-11-23 05:08:45-05,50,78184,47891
212554865,535472323302682600,2014-11-23 05:38:45-05,64,78248,122446
212554866,535472323302682600,2014-11-23 06:08:45-05,46,78294,114590
212554867,535472323302682600,2014-11-23 06:38:45-05,57,78351,118381
212554868,535472323302682600,2014-11-23 07:08:45-05,51,78402,77048
212554869,535472323302682600,2014-11-23 07:38:45-05,75,78477,110614
212554870,535472323302682600,2014-11-23 08:08:45-05,67,78544,118039
212554871,535472323302682600,2014-11-23 08:38:45-05,70,78614,100995
212554872,535472323302682600,2014-11-23 09:08:45-05,77,78691,160714
212554873,535472323302682600,2014-11-23 09:38:45-05,73,78764,150335
212554874,535472323302682600,2014-11-23 10:08:45-05,76,78840,116017
212554875,535472323302682600,2014-11-23 10:38:45-05,164,79004,309155
212554876,535472323302682600,2014-11-23 11:08:45-05,190,79194,380537
212554877,535472323302682600,2014-11-23 11:38:45-05,161,79355,335426
212554878,535472323302682600,2014-11-23 12:08:45-05,116,79471,216102
212554879,535472323302682600,2014-11-23 12:38:45-05,87,79558,111427
212554880,535472323302682600,2014-11-23 13:08:45-05,438,79996,789029
212554881,535472323302682600,2014-11-23 13:38:45-05,120,80116,225369
212554882,535472323302682600,2014-11-23 14:08:45-05,103,80219,176362
212554883,535472323302682600,2014-11-23 14:38:45-05,85,80304,108098
212554884,535472323302682600,2014-11-23 15:08:45-05,77,80381,96472
212554885,535472323302682600,2014-11-23 15:38:45-05,83,80464,151226
212554886,535472323302682600,2014-11-23 16:08:45-05,168,80632,276479
212554887,535472323302682600,2014-11-23 16:38:45-05,71,80703,143611
212554888,535472323302682600,2014-11-23 17:08:45-05,52,80755,79110
212554889,535472323302682600,2014-11-23 17:38:45-05,60,80815,123801
212554890,535472323302682600,2014-11-23 18:08:45-05,71,80886,102075
212554891,535472323302682600,2014-11-23 18:38:45-05,45,80931,63230
212554892,535472323302682600,2014-11-23 19:08:45-05,38,80969,166644
212554893,535472323302682600,2014-11-23 19:38:45-05,51,81020,67733
212554894,535472323302682600,2014-11-23 20:08:45-05,42,81062,49673
212554895,535472323302682600,2014-11-23 20:38:45-05,53,81115,37399
212554896,535472323302682600,2014-11-23 21:08:45-05,50,81165,74941
212554897,535472323302682600,2014-11-23 21:38:45-05,39,81204,52728
212554898,535472323302682600,2014-11-23 22:08:45-05,44,81248,48231
212554899,535472323302682600,2014-11-23 22:38:45-05,38,81286,71207
212554900,535472323302682600,2014-11-23 23:08:45-05,37,81323,37651
212554901,535472323302682600,2014-11-23 23:38:45-05,39,81362,83179
212554902,535472323302682600,2014-11-24 00:08:45-05,34,81396,41681
212554903,535472323302682600,2014-11-24 00:38:45-05,61,81457,113659
212554904,535472323302682600,2014-11-24 01:08:45-05,24,81481,39164
212554905,535472323302682600,2014-11-24 01:38:45-05,62,81543,136028
212554906,535472323302682600,2014-11-24 02:08:45-05,30,81573,40324
212554907,535472323302682600,2014-11-24 02:38:45-05,12,81585,17378
212554908,535472323302682600,2014-11-24 03:08:45-05,13,81598,10260
212554909,535472323302682600,2014-11-24 03:38:45-05,20,81618,43880
212554910,535472323302682600,2014-11-24 04:08:45-05,25,81643,56123
212554911,535472323302682600,2014-11-24 04:38:45-05,18,81661,26989
212554912,535472323302682600,2014-11-24 05:08:45-05,20,81681,48369
212554913,535472323302682600,2014-11-24 05:38:45-05,28,81709,55956
212554914,535472323302682600,2014-11-24 06:08:45-05,24,81733,40004
212554915,535472323302682600,2014-11-24 06:38:45-05,26,81759,22021
212554916,535472323302682600,2014-11-24 07:08:45-05,35,81794,88948
212554917,535472323302682600,2014-11-24 07:38:45-05,29,81823,29467
212554918,535472323302682600,2014-11-24 08:08:45-05,31,81854,32766
212554919,535472323302682600,2014-11-24 08:38:45-05,34,81888,78931
212554920,535472323302682600,2014-11-24 09:08:45-05,32,81920,54588
212554921,535472323302682600,2014-11-24 09:38:45-05,35,81955,46167
212554922,535472323302682600,2014-11-24 10:08:45-05,37,81992,50288
212554923,535472323302682600,2014-11-24 10:38:45-05,46,82038,50966
212554924,535472323302682600,2014-11-24 11:08:45-05,40,82078,94907
212554925,535472323302682600,2014-11-24 11:38:45-05,48,82126,66418
212554926,535472323302682600,2014-11-24 12:08:45-05,52,82178,100006
212554927,535472323302682600,2014-11-24 12:38:45-05,45,82223,54353
212554928,535472323302682600,2014-11-24 13:08:45-05,34,82257,57778
212554929,535472323302682600,2014-11-24 13:38:45-05,36,82293,51727
212554930,535472323302682600,2014-11-24 14:08:45-05,36,82329,38699
212554931,535472323302682600,2014-11-24 14:38:45-05,31,82360,32354
212554932,535472323302682600,2014-11-24 15:08:45-05,55,82415,141427
212554933,535472323302682600,2014-11-24 15:38:45-05,53,82468,68917
212554934,535472323302682600,2014-11-24 16:08:45-05,42,82510,41960
212554935,535472323302682600,2014-11-24 16:38:45-05,50,82560,60293
212554936,535472323302682600,2014-11-24 17:08:45-05,44,82604,61896
212554937,535472323302682600,2014-11-24 17:38:45-05,38,82642,61948
212554938,535472323302682600,2014-11-24 18:08:45-05,81,82723,157323
212554939,535472323302682600,2014-11-24 18:38:45-05,49,82772,48106
212554940,535472323302682600,2014-11-24 19:08:45-05,28,82800,42777
212554941,535472323302682600,2014-11-24 19:38:45-05,35,82835,66194
212554942,535472323302682600,2014-11-24 20:08:45-05,35,82870,29392
212554943,535472323302682600,2014-11-24 20:38:45-05,28,82898,65699
212554944,535472323302682600,2014-11-24 21:08:45-05,50,82948,56894
212554945,535472323302682600,2014-11-24 21:38:45-05,23,82971,41783
212554946,535472323302682600,2014-11-24 22:08:45-05,24,82995,33897
212554947,535472323302682600,2014-11-24 22:38:45-05,21,83016,25265
212554948,535472323302682600,2014-11-24 23:08:45-05,21,83037,17837
212554949,535472323302682600,2014-11-24 23:38:45-05,24,83061,33730
212554950,535472323302682600,2014-11-25 00:08:45-05,14,83075,15722
212554951,535472323302682600,2014-11-25 00:38:45-05,23,83098,15925
212554952,535472323302682600,2014-11-25 01:08:45-05,15,83113,13803
212554953,535472323302682600,2014-11-25 01:38:45-05,12,83125,15565
212554954,535472323302682600,2014-11-25 02:08:45-05,12,83137,13992
212554955,535472323302682600,2014-11-25 02:38:45-05,17,83154,27347
212554956,535472323302682600,2014-11-25 03:08:45-05,12,83166,12054
212554957,535472323302682600,2014-11-25 03:38:45-05,10,83176,11241
212554958,535472323302682600,2014-11-25 04:08:45-05,6,83182,17292
212554959,535472323302682600,2014-11-25 04:38:45-05,33,83215,54773
212554960,535472323302682600,2014-11-25 05:08:45-05,17,83232,26836
212554961,535472323302682600,2014-11-25 05:38:45-05,15,83247,20740
212554962,535472323302682600,2014-11-25 06:08:45-05,7,83254,3763
212554963,535472323302682600,2014-11-25 06:38:45-05,19,83273,21792
212554964,535472323302682600,2014-11-25 07:08:45-05,14,83287,40867
212554965,535472323302682600,2014-11-25 07:38:45-05,20,83307,18908
212554966,535472323302682600,2014-11-25 08:08:45-05,19,83326,44764
212554967,535472323302682600,2014-11-25 08:38:45-05,23,83349,40571
212554968,535472323302682600,2014-11-25 09:08:45-05,25,83374,89199
212554969,535472323302682600,2014-11-25 09:38:45-05,29,83403,27869
212554970,535472323302682600,2014-11-25 10:08:45-05,39,83442,42880
212554971,535472323302682600,2014-11-25 10:38:45-05,102,83544,185783
212554972,535472323302682600,2014-11-25 11:08:45-05,68,83612,92399
212554973,535472323302682600,2014-11-25 11:38:45-05,39,83651,39742
212554974,535472323302682600,2014-11-25 12:08:45-05,21,83672,20985
212554975,535472323302682600,2014-11-25 12:38:45-05,39,83711,54849
212554976,535472323302682600,2014-11-25 13:08:45-05,25,83736,40353
212554977,535472323302682600,2014-11-25 13:38:45-05,30,83766,83513
212554978,535472323302682600,2014-11-25 14:08:45-05,34,83800,35410
212554979,535472323302682600,2014-11-25 14:38:45-05,28,83828,83681
212554980,535472323302682600,2014-11-25 15:08:45-05,34,83862,61403
212554981,535472323302682600,2014-11-25 15:38:45-05,33,83895,35279
212554982,535472323302682600,2014-11-25 16:08:45-05,28,83923,60464
212554983,535472323302682600,2014-11-25 16:38:45-05,30,83953,61237
212554984,535472323302682600,2014-11-25 17:08:45-05,32,83985,47677
212554985,535472323302682600,2014-11-25 17:38:45-05,34,84019,64027
212554986,535472323302682600,2014-11-25 18:08:45-05,26,84045,24629
212554987,535472323302682600,2014-11-25 18:38:45-05,21,84066,15392
212554988,535472323302682600,2014-11-25 19:08:45-05,33,84099,52852
212554989,535472323302682600,2014-11-25 19:38:45-05,22,84121,15787
212554990,535472323302682600,2014-11-25 20:08:45-05,21,84142,14266
212554991,535472323302682600,2014-11-25 20:38:45-05,20,84162,23019
212554992,535472323302682600,2014-11-25 21:08:45-05,12,84174,16102
212554993,535472323302682600,2014-11-25 21:38:45-05,21,84195,19265
212554994,535472323302682600,2014-11-25 22:08:45-05,15,84210,28194
212554995,535472323302682600,2014-11-25 22:38:45-05,43,84253,77160
212554996,535472323302682600,2014-11-25 23:08:45-05,42,84295,140632
212554997,535472323302682600,2014-11-25 23:38:45-05,19,84314,35356
212554998,535472323302682600,2014-11-26 00:08:45-05,20,84334,14709
212554999,535472323302682600,2014-11-26 00:38:45-05,16,84350,12811
212555000,535472323302682600,2014-11-26 01:08:45-05,10,84360,7745
212555001,535472323302682600,2014-11-26 01:38:45-05,11,84371,14644
212555002,535472323302682600,2014-11-26 02:08:45-05,5,84376,24693
212555003,535472323302682600,2014-11-26 02:38:45-05,12,84388,10828
212555004,535472323302682600,2014-11-26 03:08:45-05,14,84402,22820
212555005,535472323302682600,2014-11-26 03:38:45-05,14,84416,12473
212555006,535472323302682600,2014-11-26 04:08:45-05,7,84423,8072
212555007,535472323302682600,2014-11-26 04:38:45-05,12,84435,4594
212555008,535472323302682600,2014-11-26 05:08:45-05,9,84444,24168
212555009,535472323302682600,2014-11-26 05:38:45-05,18,84462,22585
212555010,535472323302682600,2014-11-26 06:08:45-05,15,84477,13332
212555011,535472323302682600,2014-11-26 06:38:45-05,19,84496,38505
212555012,535472323302682600,2014-11-26 07:08:45-05,19,84515,24381
212555013,535472323302682600,2014-11-26 07:38:45-05,22,84537,34351
212555014,535472323302682600,2014-11-26 08:08:45-05,18,84555,22154
212555015,535472323302682600,2014-11-26 08:38:45-05,18,84573,15356
212555016,535472323302682600,2014-11-26 09:08:45-05,35,84608,43260
212555017,535472323302682600,2014-11-26 09:38:45-05,20,84628,28218
212555018,535472323302682600,2014-11-26 10:08:45-05,10,84638,15202
212555019,535472323302682600,2014-11-26 10:38:45-05,21,84659,44434
212555020,535472323302682600,2014-11-26 11:08:45-05,36,84695,48314
212555021,535472323302682600,2014-11-26 11:38:45-05,14,84709,21172
212555022,535472323302682600,2014-11-26 12:08:45-05,20,84729,48674
212555023,535472323302682600,2014-11-26 12:38:45-05,19,84748,19057
212555024,535472323302682600,2014-11-26 13:08:45-05,64,84812,67534
212555025,535472323302682600,2014-11-26 13:38:45-05,44,84856,83765
212555026,535472323302682600,2014-11-26 14:08:45-05,26,84882,56717
212555027,535472323302682600,2014-11-26 14:38:45-05,31,84913,19819
212555028,535472323302682600,2014-11-26 15:08:45-05,28,84941,46257
212555029,535472323302682600,2014-11-26 15:38:45-05,30,84971,46699
212555030,535472323302682600,2014-11-26 16:08:45-05,33,85004,25391
212555031,535472323302682600,2014-11-26 16:38:45-05,31,85035,29463
212555032,535472323302682600,2014-11-26 17:08:45-05,17,85052,49750
212555033,535472323302682600,2014-11-26 17:38:45-05,25,85077,19449
212555034,535472323302682600,2014-11-26 18:08:45-05,30,85107,46621
212555035,535472323302682600,2014-11-26 18:38:45-05,33,85140,43886
212555036,535472323302682600,2014-11-26 19:08:45-05,36,85176,76426
212555037,535472323302682600,2014-11-26 19:38:45-05,33,85209,56354
212555038,535472323302682600,2014-11-26 20:08:45-05,23,85232,26881
212555039,535472323302682600,2014-11-26 20:38:45-05,27,85259,43822
212555040,535472323302682600,2014-11-26 21:08:45-05,20,85279,15389
212555041,535472323302682600,2014-11-26 21:38:45-05,16,85295,16726
212555042,535472323302682600,2014-11-26 22:08:45-05,14,85309,18831
212555043,535472323302682600,2014-11-26 22:38:45-05,13,85322,28208
212555044,535472323302682600,2014-11-26 23:08:45-05,13,85335,14403
212555045,535472323302682600,2014-11-26 23:38:45-05,15,85350,24825
212555046,535472323302682600,2014-11-27 00:08:45-05,54,85404,69559
212555047,535472323302682600,2014-11-27 00:38:45-05,64,85468,85976
212555048,535472323302682600,2014-11-27 01:08:45-05,16,85484,35650
212555049,535472323302682600,2014-11-27 01:38:45-05,14,85498,8009
212555050,535472323302682600,2014-11-27 02:08:45-05,12,85510,5080
212555051,535472323302682600,2014-11-27 02:38:45-05,11,85521,49539
212555052,535472323302682600,2014-11-27 03:08:45-05,12,85533,9931
212555053,535472323302682600,2014-11-27 03:38:45-05,7,85540,18100
212555054,535472323302682600,2014-11-27 04:08:45-05,8,85548,9042
212555055,535472323302682600,2014-11-27 04:38:45-05,9,85557,7146
212555056,535472323302682600,2014-11-27 05:08:45-05,11,85568,13312
212555057,535472323302682600,2014-11-27 05:38:45-05,14,85582,14252
212555058,535472323302682600,2014-11-27 06:08:45-05,11,85593,24860
212555059,535472323302682600,2014-11-27 06:38:45-05,18,85611,25713
212555060,535472323302682600,2014-11-27 07:08:45-05,17,85628,10143
212555061,535472323302682600,2014-11-27 07:38:45-05,18,85646,14304
212555062,535472323302682600,2014-11-27 08:08:45-05,20,85666,192223
212555063,535472323302682600,2014-11-27 08:38:45-05,24,85690,112802
212555064,535472323302682600,2014-11-27 09:08:45-05,23,85713,62272
212555065,535472323302682600,2014-11-27 09:38:45-05,25,85738,45528
212555066,535472323302682600,2014-11-27 10:08:45-05,35,85773,63777
212555067,535472323302682600,2014-11-27 10:38:45-05,32,85805,21728
212555068,535472323302682600,2014-11-27 11:08:45-05,26,85831,36559
212555069,535472323302682600,2014-11-27 11:38:45-05,28,85859,25666
212555070,535472323302682600,2014-11-27 12:08:45-05,24,85883,37891
212555071,535472323302682600,2014-11-27 12:38:45-05,13,85896,13469
212555072,535472323302682600,2014-11-27 13:08:45-05,12,85908,12426
212555073,535472323302682600,2014-11-27 13:38:45-05,26,85934,37200
212555074,535472323302682600,2014-11-27 14:08:45-05,23,85957,33706
212555075,535472323302682600,2014-11-27 14:38:45-05,18,85975,46556
212555076,535472323302682600,2014-11-27 15:08:45-05,24,85999,76679
212555077,535472323302682600,2014-11-27 15:38:45-05,17,86016,39649
212555078,535472323302682600,2014-11-27 16:08:45-05,17,86033,30223
212555079,535472323302682600,2014-11-27 16:38:45-05,17,86050,51476
212555080,535472323302682600,2014-11-27 17:08:45-05,31,86081,35940
212555081,535472323302682600,2014-11-27 17:38:45-05,25,86106,16460
212555082,535472323302682600,2014-11-27 18:08:45-05,17,86123,17433
212555083,535472323302682600,2014-11-27 18:38:45-05,13,86136,10338
212555084,535472323302682600,2014-11-27 19:08:45-05,20,86156,28028
212555085,535472323302682600,2014-11-27 19:38:45-05,21,86177,17507
212555086,535472323302682600,2014-11-27 20:08:45-05,73,86250,102101
212555087,535472323302682600,2014-11-27 20:38:45-05,31,86281,71760
212555088,535472323302682600,2014-11-27 21:08:45-05,16,86297,23184
212555089,535472323302682600,2014-11-27 21:38:45-05,19,86316,11273
212555090,535472323302682600,2014-11-27 22:08:45-05,15,86331,14098
212555091,535472323302682600,2014-11-27 22:38:45-05,7,86338,3345
212555092,535472323302682600,2014-11-27 23:08:45-05,12,86350,11755
212555093,535472323302682600,2014-11-27 23:38:45-05,8,86358,5396
212555094,535472323302682600,2014-11-28 00:08:45-05,8,86366,8680
212555095,535472323302682600,2014-11-28 00:38:45-05,10,86376,16311
212555096,535472323302682600,2014-11-28 01:08:45-05,10,86386,1781
212555097,535472323302682600,2014-11-28 01:38:45-05,6,86392,2738
212555098,535472323302682600,2014-11-28 02:08:45-05,5,86397,6167
212555099,535472323302682600,2014-11-28 02:38:45-05,4,86401,3318
212555100,535472323302682600,2014-11-28 03:08:45-05,8,86409,12599
212555101,535472323302682600,2014-11-28 03:38:45-05,10,86419,8366
212555102,535472323302682600,2014-11-28 04:08:45-05,4,86423,2395
212555103,535472323302682600,2014-11-28 04:38:45-05,8,86431,13225
212555104,535472323302682600,2014-11-28 05:08:45-05,3,86434,298
212555105,535472323302682600,2014-11-28 05:38:45-05,10,86444,8342
212555106,535472323302682600,2014-11-28 06:08:45-05,7,86451,11736
212555107,535472323302682600,2014-11-28 06:38:45-05,10,86461,24398
212555108,535472323302682600,2014-11-28 07:08:45-05,18,86479,20709
212555109,535472323302682600,2014-11-28 07:38:45-05,20,86499,41891
212555110,535472323302682600,2014-11-28 08:08:45-05,14,86513,19251
212555111,535472323302682600,2014-11-28 08:38:45-05,11,86524,24157
212555112,535472323302682600,2014-11-28 09:08:45-05,16,86540,29068
212555113,535472323302682600,2014-11-28 09:38:45-05,13,86553,12068
212555114,535472323302682600,2014-11-28 10:08:45-05,18,86571,24078
212555115,535472323302682600,2014-11-28 10:38:45-05,13,86584,13261
212555116,535472323302682600,2014-11-28 11:08:45-05,25,86609,21112
212555117,535472323302682600,2014-11-28 11:38:45-05,22,86631,35605
212555118,535472323302682600,2014-11-28 12:08:45-05,19,86650,15834
212555119,535472323302682600,2014-11-28 12:38:45-05,16,86666,21696
212555120,535472323302682600,2014-11-28 13:08:45-05,17,86683,24357
212555121,535472323302682600,2014-11-28 13:38:45-05,21,86704,22109
212555122,535472323302682600,2014-11-28 14:08:45-05,18,86722,28673
212555123,535472323302682600,2014-11-28 14:38:45-05,25,86747,29342
212555124,535472323302682600,2014-11-28 15:08:45-05,14,86761,12760
212555125,535472323302682600,2014-11-28 15:38:45-05,16,86777,16110
212555126,535472323302682600,2014-11-28 16:08:45-05,17,86794,12147
212555127,535472323302682600,2014-11-28 16:38:45-05,12,86806,9417
212555128,535472323302682600,2014-11-28 17:08:45-05,13,86819,18506
212555129,535472323302682600,2014-11-28 17:38:45-05,15,86834,17747
212555130,535472323302682600,2014-11-28 18:08:45-05,29,86863,55657
212555131,535472323302682600,2014-11-28 18:38:45-05,16,86879,12994
212555132,535472323302682600,2014-11-28 19:08:45-05,17,86896,24037
212555133,535472323302682600,2014-11-28 19:38:45-05,18,86914,40143
212555134,535472323302682600,2014-11-28 20:08:45-05,10,86924,21797
212555135,535472323302682600,2014-11-28 20:38:45-05,12,86936,161180
212555136,535472323302682600,2014-11-28 21:08:45-05,14,86950,24117
212555137,535472323302682600,2014-11-28 21:38:45-05,11,86961,20301
212555138,535472323302682600,2014-11-28 22:08:45-05,14,86975,10532
212555139,535472323302682600,2014-11-28 22:38:45-05,13,86988,28212
212555140,535472323302682600,2014-11-28 23:08:45-05,8,86996,3536
212555141,535472323302682600,2014-11-28 23:38:45-05,8,87004,3314
212555142,535472323302682600,2014-11-29 00:08:45-05,12,87016,13741
212555143,535472323302682600,2014-11-29 00:38:45-05,8,87024,36290
212555144,535472323302682600,2014-11-29 01:08:45-05,10,87034,8388
212555145,535472323302682600,2014-11-29 01:38:45-05,8,87042,8323
212555146,535472323302682600,2014-11-29 02:08:45-05,5,87047,2832
212555147,535472323302682600,2014-11-29 02:38:45-05,5,87052,2295
212555148,535472323302682600,2014-11-29 03:08:45-05,10,87062,6952
212555149,535472323302682600,2014-11-29 03:38:45-05,7,87069,5242
212555150,535472323302682600,2014-11-29 04:08:45-05,10,87079,10482
212555151,535472323302682600,2014-11-29 04:38:45-05,5,87084,4864
212555152,535472323302682600,2014-11-29 05:08:45-05,10,87094,15151
212555153,535472323302682600,2014-11-29 05:38:45-05,9,87103,6478
212555154,535472323302682600,2014-11-29 06:08:45-05,9,87112,9646
212555155,535472323302682600,2014-11-29 06:38:45-05,9,87121,16217
212555156,535472323302682600,2014-11-29 07:08:45-05,10,87131,13137
212555157,535472323302682600,2014-11-29 07:38:45-05,10,87141,13087
212555158,535472323302682600,2014-11-29 08:08:45-05,15,87156,37007
212555159,535472323302682600,2014-11-29 08:38:45-05,14,87170,30278
212555160,535472323302682600,2014-11-29 09:08:45-05,18,87188,44683
212555161,535472323302682600,2014-11-29 09:38:45-05,13,87201,35170
